15 15 15 15 15 15 15 15 15 15 15 15 15 15 15 15 15 15 15 15 15 15 15 15 15 15 15 15 15 15 15 15 15 15 15 15 15 15 15 15 15 15 15 15 15 15 15 15 15 15
15 15 15 15 15 15 15 15 15 15 15 15 15 15 15 15 15 15 15 15 15 15 15 15 15 15 15 15 15 15 15 15 15 15 15 15 15 15 15 15 15 15 15 15 15 15 15 15 15 15
15 15 15 15 15 15 15 15 15 15 15 15 15 15 15 15 15 15 15 15 15 15 15 15 15 15 15 15 15 15 15 15 15 15 15 15 15 15 15 15 15 15 15 15 15 15 15 15 15 15
15 15 15 15 15 15 15 15 15 15 15 15 15 15 15 15 15 15 15 15 15 15 15 15 15 15 15 15 15 15 15 15 15 15 15 15 15 15 15 15 15 15 15 15 15 15 15 15 15 15
15 15 15 15 15 15 15 15 15 15 15 15 15 15 15 15 15 15 15 15 15 15 15 15 15 15 15 15 15 15 15 15 15 15 15 15 15 15 15 15 15 15 15 15 15 15 15 15 15 15
15 15 15 15 15 15 15 15 15 15 15 15 15 15 15 15 15 15 15 15 15 15 15 15 15 15 15 15 15 15 15 15 15 15 15 15 15 15 15 15 15 15 15 15 15 15 15 15 15 15
15 15 15 15 15 15 15 15 15 15 15 15 15 15 15 15 15 15 15 15 15 15 15 15 15 15 15 15 15 10 10 10 10 10 15 15 15 15 15 15 15 15 15 15 15 15 15 15 15 15
15 15 15 15 15 15 15 15 15 10 10 10 10 10 15 15 15 15 10 10 10 15 15 15 15 10 10 10 10 10 10 10 10 10 10 10 10 10 10 10 10 15 15 15 15 15 15 15 15 15
15 15 15 15 15 15 15 15 15 10 10 10 10 10 10 15 15 15 10 10 10 10 10 10 10 10 10 10 10 15 15 10 10 10 10 10 10 10 16 10 10 10 15 15 15 15 15 15 15 15
15 15 15 15 15 15 15 15 10 10 10 10 10 10 10 10 10 10 10 10 10 15 15 15 10 10 10 10 15 15 15 15 15 10 10 10 16 16 16 16 10 10 15 15 15 15 15 15 15 15
15 15 15 15 15 15 15 15 10 10 10 10 10 10 15 15 15 15 15 15 15 15 15 15 15 10 10 15 15 12 19 19 20 10 10 10 10 16 16 10 10 10 15 15 15 15 15 15 15 15
15 15 15 15 15 15 15 15 10 10 10 10 10 15 15 15 15 15 15 15 15 15 12 20 15 10 10 15 12 12 12 12 12 12 10 10 10 16 10 10 10 12 19 19 19 19 19 19 19 19
15 15 15 15 15 15 15 15 11 11 16 11 11 15 15 15 15 15 15 15 15 12 12 12 15 10 10 15 12 15 15 15 23 12 12 10 10 10 10 12 12 25 24 24 24 24 24 24 24 24
15 15 15 15 15 15 15 15 11 16 16 16 11 15 15 12 19 19 19 19 12 12 25 15 15 10 10 15 15 15 15 15 15 23 12 12 19 19 12 12 25 15 15 15 15 15 15 15 15 15
15 15 15 15 15 15 15 15 11 16 16 16 11 15 15 12 12 12 24 24 24 25 15 15 10 10 10 15 15 15 15 15 15 15 23 23 12 12 12 25 15 15 15 15 15 15 15 15 15 15
15 15 15 15 15 15 15 15 11 16 16 16 11 15 12 12 25 15 15 15 15 15 15 15 10 10 10 15 15 10 16 15 15 15 15 15 15 12 12 15 15 15 15 15 15 15 15 15 15 15
15 15 15 15 15 15 15 15 11 16 16 16 11 15 21 12 15 15 15 15 15 15 15 10 10 10 15 15 15 16 16 10 15 15 15 15 15 21 22 15 15 15 15 15 15 15 15 15 15 15
15 15 15 15 15 15 15 15 11 11 11 11 11 15 21 22 15 15 15 15 15 10 10 10 10 10 15 15 15 10 16 16 10 15 15 15 15 12 22 15 15 15 15 15 15 15 15 15 15 15
15 15 15 15 15 15 15 15 15 15 15 15 15 15 21 22 15 15 15 15 10 10 10 13 10 10 15 15 15 15 10 10 10 10 15 15 15 12 22 15 15 15 15 15 15 15 15 15 15 15
15 15 15 15 15 15 15 15 15 15 15 15 15 15 21 22 15 10 10 10 10 10 10 13 10 10 10 15 15 15 15 10 10 10 15 15 12 12 25 15 15 15 15 15 15 15 15 15 15 15
15 15 15 15 15 15 15 15 15 15 15 15 15 15 21 22 15 10 10 10 10 10 13 13 13 10 10 10 10 10 10 10 15 15 15 12 12 25 15 15 10 10 15 15 15 15 15 15 15 15
15 15 15 15 15 15 15 15 15 15 15 15 15 18 29 22 15 15 10 10 13 13 13 13 13 13 13 10 10 10 10 10 15 15 15 21 12 15 15 10 16 10 15 15 15 15 15 15 15 15
15 15 15 15 15 15 15 15 15 15 15 15 15 21 12 22 15 15 10 10 10 10 13 13 13 10 10 10 10 10 15 15 15 15 15 21 12 15 15 16 16 16 15 15 15 15 15 15 15 15
15 15 15 15 15 15 15 15 15 15 15 15 15 23 27 22 15 15 10 10 10 10 10 13 10 10 10 10 10 15 15 15 15 15 15 12 22 15 15 10 10 10 15 15 15 15 15 15 15 15
15 15 15 15 15 15 15 15 15 15 15 15 15 15 21 22 15 15 10 10 10 10 10 10 10 10 10 10 15 15 15 15 15 15 12 12 25 15 15 10 10 10 15 15 15 15 15 15 15 15
15 11 11 11 11 11 11 15 15 15 15 15 15 15 21 22 15 15 15 10 10 10 10 10 10 10 15 15 15 15 15 15 15 15 21 12 15 15 15 10 10 10 15 15 15 15 15 15 15 15
15 11 16 16 16 16 11 15 15 15 15 15 15 15 21 22 15 15 15 10 10 10 15 15 15 15 15 15 15 15 15 15 15 15 21 22 15 15 10 10 10 10 15 15 15 15 15 15 15 15
15 11 16 16 16 16 11 15 15 15 15 15 15 15 23 27 20 15 15 15 10 10 15 15 15 15 15 15 15 15 15 15 15 15 12 22 15 15 10 10 10 10 15 15 15 15 15 15 15 15
15 11 16 16 16 16 11 15 15 15 15 15 15 15 15 23 12 12 20 15 10 10 15 19 19 19 19 19 19 19 19 19 19 12 12 25 15 15 10 10 10 10 15 15 15 15 15 15 15 15
15 11 16 16 16 16 11 15 15 15 15 15 15 15 15 15 23 24 25 15 10 10 15 24 24 24 24 24 24 24 24 24 24 25 15 15 15 15 10 10 10 10 15 15 15 15 15 15 15 15
15 11 11 16 11 11 11 15 15 15 15 15 15 15 15 15 15 15 15 15 10 10 15 15 15 15 15 15 15 15 15 15 15 15 15 15 15 10 10 10 10 15 15 15 15 15 15 15 15 15
15 15 15 13 15 15 15 15 15 15 15 15 15 15 15 15 15 15 15 10 10 10 10 10 15 15 15 15 15 15 15 15 15 15 15 15 10 10 10 10 15 15 15 15 15 15 15 15 15 15
13 13 13 13 15 15 15 15 15 15 15 15 15 10 16 10 10 10 10 10 10 10 10 10 10 10 10 10 10 10 10 10 10 10 10 10 10 10 10 15 15 15 15 15 15 15 15 15 15 15
15 15 15 15 15 15 15 15 15 15 15 15 10 16 16 16 10 10 10 10 10 10 10 10 10 10 10 10 10 10 10 10 10 10 10 10 10 15 15 15 15 15 15 15 15 15 15 15 15 15
15 15 15 15 15 15 15 15 15 15 15 15 10 10 16 10 10 10 10 10 10 10 10 10 10 10 10 10 10 10 10 10 10 10 10 10 15 11 11 11 11 11 15 15 15 15 15 15 15 15
15 15 15 15 15 15 15 15 15 15 15 15 15 15 15 15 15 10 10 10 10 10 10 10 10 10 10 10 10 10 10 10 10 10 10 10 15 11 16 16 16 11 15 15 15 15 15 15 15 15
15 15 15 15 15 15 15 15 15 10 10 10 10 15 15 15 15 15 15 15 10 10 10 10 10 10 10 10 10 10 10 10 10 10 10 10 15 11 16 16 16 11 15 15 15 15 15 15 15 15
15 15 15 15 15 15 15 15 10 10 10 16 10 10 10 15 15 15 15 15 15 15 15 15 15 15 15 15 15 15 10 10 10 10 13 10 15 11 16 16 16 11 15 15 15 15 15 15 15 15
15 15 15 15 15 15 15 15 10 10 16 16 16 10 10 10 10 10 10 15 15 15 15 15 15 10 10 10 10 10 10 10 10 10 13 10 15 11 16 16 16 11 15 15 15 15 15 15 15 15
15 15 15 15 15 15 15 15 10 10 16 16 10 10 10 10 10 10 10 10 10 10 10 10 10 10 10 10 10 10 10 15 11 11 13 11 11 11 16 16 16 11 15 15 15 15 15 15 15 15
15 15 15 15 15 15 15 15 15 10 10 10 10 10 10 10 10 10 10 10 10 10 10 10 10 10 10 10 10 10 15 15 11 16 16 16 16 16 16 16 16 11 15 15 15 15 15 15 15 15
15 15 15 15 15 15 15 15 15 15 10 10 10 10 10 10 10 10 10 10 10 10 10 10 10 10 10 15 15 15 15 15 11 16 16 16 16 16 16 16 16 11 15 15 15 15 15 15 15 15
15 15 15 15 15 15 15 15 15 15 15 15 15 15 15 10 10 10 10 10 10 10 10 10 15 15 15 15 15 15 15 15 11 16 16 16 16 16 16 16 16 11 15 15 15 15 15 15 15 15
15 15 15 15 15 15 15 15 15 15 15 15 15 15 15 15 15 15 15 15 15 15 15 15 15 15 15 15 15 15 15 15 11 11 11 11 11 11 11 11 11 11 15 15 15 15 15 15 15 15
15 15 15 15 15 15 15 15 15 15 15 15 15 15 15 15 15 15 15 15 15 15 15 15 15 15 15 15 15 15 15 15 15 15 15 15 15 15 15 15 15 15 15 15 15 15 15 15 15 15
15 15 15 15 15 15 15 15 15 15 15 15 15 15 15 15 15 15 15 15 15 15 15 15 15 15 15 15 15 15 15 15 15 15 15 15 15 15 15 15 15 15 15 15 15 15 15 15 15 15
15 15 15 15 15 15 15 15 15 15 15 15 15 15 15 15 15 15 15 15 15 15 15 15 15 15 15 15 15 15 15 15 15 15 15 15 15 15 15 15 15 15 15 15 15 15 15 15 15 15
15 15 15 15 15 15 15 15 15 15 15 15 15 15 15 15 15 15 15 15 15 15 15 15 15 15 15 15 15 15 15 15 15 15 15 15 15 15 15 15 15 15 15 15 15 15 15 15 15 15
15 15 15 15 15 15 15 15 15 15 15 15 15 15 15 15 15 15 15 15 15 15 15 15 15 15 15 15 15 15 15 15 15 15 15 15 15 15 15 15 15 15 15 15 15 15 15 15 15 15