5 5 5 5 5 5 5 5 5 5 5 5 5 5 5 5 5 5 5 5 5 5 5 5 5 5 5 5 5 5 5 5 5 5 5 5 5 5 5 5 5 5 5 5 5 5 5 5 5 5
5 5 5 5 5 5 5 5 5 5 5 5 5 5 5 5 5 5 5 5 5 5 5 5 5 5 5 5 5 5 5 5 5 5 5 5 5 5 5 5 5 5 5 5 5 5 5 5 5 5
5 5 5 5 5 5 5 5 5 5 5 5 5 5 5 5 5 5 5 5 5 5 5 5 5 5 5 5 5 5 5 5 5 5 5 5 5 5 5 5 5 5 5 5 5 5 5 5 5 5
5 5 5 5 5 5 5 5 5 5 5 5 5 5 5 5 5 5 5 5 5 5 5 5 5 5 5 5 5 5 5 5 5 5 5 5 5 5 5 5 5 5 5 5 5 5 5 5 5 5
5 5 5 5 5 5 5 5 5 5 5 5 5 5 5 5 5 5 5 5 5 5 5 5 5 5 5 5 5 5 5 5 5 5 5 5 5 5 5 5 5 5 5 5 5 5 5 5 5 5
5 5 5 5 5 5 5 5 5 5 5 5 5 5 5 5 5 5 5 5 5 5 5 5 5 5 5 5 5 5 5 5 5 5 5 5 5 5 5 5 5 5 5 5 5 5 5 5 5 5
5 5 5 5 5 5 5 5 5 5 5 5 5 5 5 5 5 5 5 5 5 5 5 5 5 5 5 5 5 0 0 0 0 0 5 5 5 5 5 5 5 5 5 5 5 5 5 5 5 5
5 5 5 5 5 5 5 5 5 0 0 0 0 0 5 5 5 5 0 0 0 5 5 5 5 0 0 0 0 0 0 0 0 0 0 0 0 0 0 0 0 5 5 5 5 5 5 5 5 5
5 5 5 5 5 5 5 5 5 0 0 0 0 0 0 5 5 5 0 0 0 0 0 0 0 0 0 0 0 5 5 0 0 0 0 0 0 0 6 0 0 0 5 5 5 5 5 5 5 5
5 5 5 5 5 5 5 5 0 0 0 0 0 0 0 0 0 0 0 0 0 5 5 5 0 0 0 0 5 5 5 5 5 0 0 0 6 6 6 6 0 0 5 5 5 5 5 5 5 5
5 5 5 5 5 5 5 5 0 0 0 0 0 0 5 5 5 5 5 5 5 5 5 5 5 0 0 5 5 2 2 2 2 0 0 0 0 6 6 0 0 0 5 5 5 5 5 5 5 5
5 5 5 5 5 5 5 5 0 0 0 0 0 5 5 5 5 5 5 5 5 5 2 2 5 0 0 5 2 2 2 2 2 2 0 0 0 6 0 0 0 2 2 2 2 2 2 2 2 2
5 5 5 5 5 5 5 5 1 1 6 1 1 5 5 5 5 5 5 5 5 2 2 2 5 0 0 5 2 5 5 5 2 2 2 0 0 0 0 2 2 2 2 2 2 2 2 2 2 2
5 5 5 5 5 5 5 5 1 6 6 6 1 5 5 2 2 2 2 2 2 2 2 5 5 0 0 5 5 5 5 5 5 2 2 2 2 2 2 2 2 5 5 5 5 5 5 5 5 5
5 5 5 5 5 5 5 5 1 6 6 6 1 5 5 2 2 2 2 2 2 2 5 5 0 0 0 5 5 5 5 5 5 5 2 2 2 2 2 2 5 5 5 5 5 5 5 5 5 5
5 5 5 5 5 5 5 5 1 6 6 6 1 5 2 2 2 5 5 5 5 5 5 5 0 0 0 5 5 0 6 5 5 5 5 5 5 2 2 5 5 5 5 5 5 5 5 5 5 5
5 5 5 5 5 5 5 5 1 6 6 6 1 5 2 2 5 5 5 5 5 5 5 0 0 0 5 5 5 6 6 0 5 5 5 5 5 2 2 5 5 5 5 5 5 5 5 5 5 5
5 5 5 5 5 5 5 5 1 1 1 1 1 5 2 2 5 5 5 5 5 0 0 0 0 0 5 5 5 0 6 6 0 5 5 5 5 2 2 5 5 5 5 5 5 5 5 5 5 5
5 5 5 5 5 5 5 5 5 5 5 5 5 5 2 2 5 5 5 5 0 0 0 3 0 0 5 5 5 5 0 0 0 0 5 5 5 2 2 5 5 5 5 5 5 5 5 5 5 5
5 5 5 5 5 5 5 5 5 5 5 5 5 5 2 2 5 0 0 0 0 0 0 3 0 0 0 5 5 5 5 0 0 0 5 5 2 2 2 5 5 5 5 5 5 5 5 5 5 5
5 5 5 5 5 5 5 5 5 5 5 5 5 5 2 2 5 0 0 0 0 0 3 3 3 0 0 0 0 0 0 0 5 5 5 2 2 2 5 5 0 0 5 5 5 5 5 5 5 5
5 5 5 5 5 5 5 5 5 5 5 5 5 2 2 2 5 5 0 0 3 3 3 3 3 3 3 0 0 0 0 0 5 5 5 2 2 5 5 0 6 0 5 5 5 5 5 5 5 5
5 5 5 5 5 5 5 5 5 5 5 5 5 2 2 5 5 5 0 0 0 0 3 3 3 0 0 0 0 0 5 5 5 5 5 2 2 5 5 6 6 6 5 5 5 5 5 5 5 5
5 5 5 5 5 5 5 5 5 5 5 5 5 2 2 5 5 5 0 0 0 0 0 3 0 0 0 0 0 5 5 5 5 5 5 2 2 5 5 0 6 0 5 5 5 5 5 5 5 5
5 5 5 5 5 5 5 5 5 5 5 5 5 5 2 2 5 5 0 0 0 0 0 3 0 0 0 0 0 5 5 5 5 5 5 2 2 5 5 0 0 0 5 5 5 5 5 5 5 5
5 5 5 5 5 5 5 5 5 5 5 5 5 5 2 2 5 5 0 0 0 0 0 0 0 0 0 0 5 5 5 5 5 5 2 2 2 5 5 0 0 0 5 5 5 5 5 5 5 5
5 1 1 1 1 1 1 5 5 5 5 5 5 5 2 2 5 5 5 0 0 0 0 0 0 0 5 5 5 5 5 5 5 5 2 2 5 5 5 0 0 0 5 5 5 5 5 5 5 5
5 1 6 6 6 6 1 5 5 5 5 5 5 5 2 2 5 5 5 0 0 0 5 5 5 5 5 5 5 5 5 5 5 5 2 2 5 5 0 0 0 0 5 5 5 5 5 5 5 5
5 1 6 6 6 6 1 5 5 5 5 5 5 5 2 2 2 5 5 5 0 0 5 5 5 5 5 5 5 5 5 5 5 5 2 2 5 5 0 0 0 0 5 5 5 5 5 5 5 5
5 1 6 6 6 6 1 5 5 5 5 5 5 5 5 2 2 2 2 5 0 0 5 2 2 2 2 2 2 2 2 2 2 2 2 2 5 5 0 0 0 0 5 5 5 5 5 5 5 5
5 1 6 6 6 6 1 5 5 5 5 5 5 5 5 5 2 2 2 5 0 0 5 2 2 2 2 2 2 2 2 2 2 2 5 5 5 5 0 0 0 0 5 5 5 5 5 5 5 5
5 1 1 6 1 1 1 5 5 5 5 5 5 5 5 5 5 5 5 5 0 0 5 5 5 5 5 5 5 5 5 5 5 5 5 5 5 0 0 0 0 5 5 5 5 5 5 5 5 5
5 5 5 3 5 5 5 5 5 5 5 5 5 5 5 5 5 5 5 0 0 0 0 0 5 5 5 5 5 5 5 5 5 5 5 5 0 0 0 0 5 5 5 5 5 5 5 5 5 5
3 3 3 3 5 5 5 5 5 5 5 5 5 0 6 0 0 0 0 0 0 0 0 0 0 0 0 0 0 0 0 0 0 0 0 0 0 0 0 5 5 5 5 5 5 5 5 5 5 5
5 5 5 5 5 5 5 5 5 5 5 5 0 6 6 6 0 0 0 0 0 0 0 0 0 0 0 0 0 0 0 0 0 0 0 0 0 5 5 5 5 5 5 5 5 5 5 5 5 5
5 5 5 5 5 5 5 5 5 5 5 5 0 0 6 0 0 0 0 0 0 0 0 0 0 0 0 0 0 0 0 0 0 0 0 0 5 1 1 1 1 1 5 5 5 5 5 5 5 5
5 5 5 5 5 5 5 5 5 5 5 5 5 5 5 5 5 0 0 0 0 0 0 0 0 0 0 0 0 0 0 0 0 0 0 0 5 1 6 6 6 1 5 5 5 5 5 5 5 5
5 5 5 5 5 5 5 5 5 0 0 0 0 5 5 5 5 5 5 5 0 0 0 0 0 0 0 0 0 0 0 0 0 0 0 0 5 1 6 6 6 1 5 5 5 5 5 5 5 5
5 5 5 5 5 5 5 5 0 0 0 6 0 0 0 5 5 5 5 5 5 5 5 5 5 5 5 5 5 5 0 0 0 0 3 0 5 1 6 6 6 1 5 5 5 5 5 5 5 5
5 5 5 5 5 5 5 5 0 0 6 6 6 0 0 0 0 0 0 5 5 5 5 5 5 0 0 0 0 0 0 0 0 0 3 0 5 1 6 6 6 1 5 5 5 5 5 5 5 5
5 5 5 5 5 5 5 5 0 0 6 6 0 0 0 0 0 0 0 0 0 0 0 0 0 0 0 0 0 0 0 5 1 1 3 1 1 1 6 6 6 1 5 5 5 5 5 5 5 5
5 5 5 5 5 5 5 5 5 0 0 0 0 0 0 0 0 0 0 0 0 0 0 0 0 0 0 0 0 0 5 5 1 6 6 6 6 6 6 6 6 1 5 5 5 5 5 5 5 5
5 5 5 5 5 5 5 5 5 5 0 0 0 0 0 0 0 0 0 0 0 0 0 0 0 0 0 5 5 5 5 5 1 6 6 6 6 6 6 6 6 1 5 5 5 5 5 5 5 5
5 5 5 5 5 5 5 5 5 5 5 5 5 5 5 0 0 0 0 0 0 0 0 0 5 5 5 5 5 5 5 5 1 6 6 6 6 6 6 6 6 1 5 5 5 5 5 5 5 5
5 5 5 5 5 5 5 5 5 5 5 5 5 5 5 5 5 5 5 5 5 5 5 5 5 5 5 5 5 5 5 5 1 1 1 1 1 1 1 1 1 1 5 5 5 5 5 5 5 5
5 5 5 5 5 5 5 5 5 5 5 5 5 5 5 5 5 5 5 5 5 5 5 5 5 5 5 5 5 5 5 5 5 5 5 5 5 5 5 5 5 5 5 5 5 5 5 5 5 5
5 5 5 5 5 5 5 5 5 5 5 5 5 5 5 5 5 5 5 5 5 5 5 5 5 5 5 5 5 5 5 5 5 5 5 5 5 5 5 5 5 5 5 5 5 5 5 5 5 5
5 5 5 5 5 5 5 5 5 5 5 5 5 5 5 5 5 5 5 5 5 5 5 5 5 5 5 5 5 5 5 5 5 5 5 5 5 5 5 5 5 5 5 5 5 5 5 5 5 5
5 5 5 5 5 5 5 5 5 5 5 5 5 5 5 5 5 5 5 5 5 5 5 5 5 5 5 5 5 5 5 5 5 5 5 5 5 5 5 5 5 5 5 5 5 5 5 5 5 5
5 5 5 5 5 5 5 5 5 5 5 5 5 5 5 5 5 5 5 5 5 5 5 5 5 5 5 5 5 5 5 5 5 5 5 5 5 5 5 5 5 5 5 5 5 5 5 5 5 5